###########################################
#                    #              #     #
#                                   #     #
#           #                       #     #
#    #####  #############         ###     #
#        #              #                 #
#        #            ###  ####     ####  #
#        #              #     #     #  #  #
#        #            ###############  ####
#        #                                #
#  #######  #  #         ######           #
#     #     #  #              #        #  #
#     #     ######            ##########  #
#     #     #                          #  #
#  ##########             ###########  ####
#  #           #                    #     #
#  #           #                    #######
#  #     #     #           #           #  #
#  #     #  ####    ###########      ###  #
#  #     #  #                 #           #
###########################################
